Mode JL
Size 7/6
Diff hard
Star 10/20/30
1,1,1,1,1,1,1
1,1,0,0,0,1,1
1,1,1,1,1,1,1
1,1,1,0,0,1,1
1,1,1,1,1,1,1
1,1,1,1,1,1,1